1111111111111111111111111111111111111111111111111111111111
1.......11...1.........C1111.............................1
1..P....11.................1.....................1.......1
1.......11...1.............1.....1...111111111111111.....1
11...11111..11111111111....1.....1.................1.....1
1C.....1....1.........111111.....1.................1.....1
1......1....1.........1....1.C...1.................1.....1
1......1....1.........1....1111111.................1.....1
1...........1.........1............................1.....1
1...........1.........1..........1111111111........1.....1
1......1....1111..............11111111111111111...11.....1
1......1....1..................1.1111111111..............1
1......1..............1........1.........................1
1......1..............1........1.........................1
1......1..............1C.......1.........................1
1......111111.....11111111111..1111111111111111111.......1
1......1...................1...1.........................1
1......1...111111111111111.1.C.1.........................1
1......1...1...............11111...11..1..11..1..........1
1......1...1.......................1...1..1...1..........1
1......1...1.........111...........11111..1...1..........1
1......1...1.........1C...................11111..........1
1......1...1.........111.................................1
1..........1..............................1111...........1
1..........1.............................1C..............1
1......1...1.............................111111..........1
1..111111111..11111.........................1............1
1..1..............1......................1111111.........1
1..1........................................1............1
1..1C.............1........................1.1.......C...1
1..111111111111111111111111111111.111111111111111111111111
1......................E1....1.........................C.1
1111111111111111111111111111111111111111111111111111111111